"#########",
"#a.....b#",
"#####.###",
"#...#...#",
"#.#####.#",
"#.#...#.#",
"###.#####",
"#b.....a#",
"#########"